SO  xpmsprites/redbrick.XPM

F        50   , 100,   0

WE xpmsprites/colorstone.XPM

EA      xpmsprites/bluestone.XPM
C      100   , 200    , 255
NO    xpmsprites/wood.XPM


1111111111111111
   111100000111111111111
  111110111011111111
 11111101 1000011111111
1111111011110101111
11111000110011011111
11111011110111011
11110000000100011
111100000001010111
111100000001010011
11110000S0000110111
111100000000111011
11110001000111101
11110001000111101
11110001000111001
11110001000111101
11110001000111101
111100000001111001
111100000001111011
111110001100111011111
111110001100111011111
111110001100111011111
1111100011001110001111
11111000110000000011111
111110001100110000111
1111100011001111101
1111100011001000001
1111100011001011111
11111000110010001111
11111000110011001111
11110000000111001
11110001000001111
11110001000100011
11110001000111011
111100010001010111
111100010001010111
111100000001010111
111100000001000011
11110000000111011
11110000000111011
1111111011001101111
111  110111011011111
111111101 1000011111
111 11111 11111111
