SO  xpmsprites/redbrick.XPM
WE xpmsprites/colorstone.XPM
EA      xpmsprites/bluestone.XPM
NO    xpmsprites/wood.XPM

F        150   , 150,  150 
C      100   , 100    ,255

1111111111111111
   111100000111111111111
  111110111011111111
 11111101 1000011111111
1111111011110101111
11111000110011011111
11111011110111011
11110000000100011
111100000001010111
111100000001010011
11110000S0000110111
111100000000111011
11110001000111101
11110001000111101
11110001000111101
11110001000111101
11110001000111101
11110000000111101
11110000000111101
11110000000111101
111100010000000011
11110001000111011
11110001000111011
111100010001010111
111100010001010111
111100000001010111
111100000001000011
11110000000111011
11110000000111011
1111111011001101111
111  110111011011111
111111101 1000011111
111 11111 11111111
